ducker D AH K ER
hey HH EY
huy	HH Y UW IY
hoy	HH OY
hiy	HH AY IY
heiy	HH EY IY
hiey	HH AY IY
dacker	D AE K AH R
duuker	D Y UW AH K AH R
daaker	D AA K AH R
dicker	D IH K ER
A	AH
A(2)	EY
B	B IY
C	S IY
D	D IY
E	IY
F	EH F
G	JH IY
H	EY CH
I	AY
J	JH EY
K	K EY
L	EH L
M	EH M
N	EH N
O	OW
P	P IY
Q	K Y UW
R	AA R
S	EH S
T	T IY
U	Y UW
V	V IY
W	D AH B AH L Y UW
X	EH K S
Y	W AY
Z	Z IY
AU	OW
OU	UW
EU	Y UW
EI	IY
AI	AY
AI(2)	EY AY